1111111111111
1E01000C00001
1000011111001
1P0011P000001
1111111111111
